0, 0, 0, 0, 2, 0, 0, 0, 2, 0, 0, 0, 0,
0, 0, 0, 0, 5, 0, 0, 0, 1, 0, 0, 0, 0,
0, 0, 0, 4, 5, 0, 0, 4, 1, 1, 1, 1, 0,
0, 4, 5, 5, 5, 0, 0, 0, 0, 0, 4, 1, 0,
5, 5, 5, 0, 0, 4, 0, 0, 4, 0, 0, 1, 0,
5, 0, 0, 0, 1, 1, 1, 1, 1, 1, 1, 1, 2,
5, 4, 0, 4, 1, 0, 4, 0, 0, 4, 0, 1, 0,
5, 0, 0, 0, 1, 0, 0, 0, 0, 0, 0, 1, 0,
5, 0, 4, 0, 1, 0, 0, 0, 0, 0, 4, 1, 0,
3, 1, 1, 1, 1, 4, 0, 0, 0, 0, 0, 2, 0,
